##############################################
#............................................#
#................................##..........#
#................................#...........#
#................................#...........#
#..............##..#.##......................#
#.....................#......................#
#.....................#......................#
#..............###...........................#
#............................................#
#.....E..........................E...........#
#............................................#
#............................................#
#.....................###....................#
#....................##.#....................#
#....................#.......................#
#...###......................................#
#...#..................................E.....#
#............................................#
#............................................#
##############################################